070 Shake & Ken Carson - Natural Habitat
070 Shake - Black Dress
7 Year Bitch - Miss Understood
ANOHNI - 4 Degrees
Acid Tongue - Consumerism
Adorable - Homeboy
African Tribal Orchestra - Vibrant Night
Al Dos Band - Doing Our Thing with Pride
Alabaster Deplume feat. Momoko Gill & MettaShiba - Did You Know
Alfa Mist - Foreword
Alien Weaponry - Hypocrite
All Things Must Pass - Billy Preston - Encouraging Words
Aloe Blacc - I Need a Dollar
Alphaville - Big in Japan
Alton Ellis - Someone
Amanda Whiting - Suspended
Amber Mark - FOMO
Ambrosia - Erick The Architect feat. Channel Tres - Ambrosia
Amy Winehouse - Back to Black
An Autumn for Crippled Children - The Feels Like Dying
Anachnid - Animism
Ancient Infinity Orchestra - Love Song
Anthony B - Hold the Faith
Anthony B - Trodding
Arctic Monkeys - 505
Atlas Air - Massive Attack - Heligoland
Auf Wiedersehen - Cheap Trick - Heaven Tonight
August Greene & Brandy - Optimistic
Auragraph - 666 Ambience
Automatic - Automaton
Azaxx - Fiesta Tropical
B. Cool-Aid feat. Quelle Chris, Denmark Vessey, Jimetta Rose, V.C.R, MoRuf & ... - Brandy, Aaliyah
BADBADNOTGOOD & Charlotte Day Wilson - Sleeper
BALTHVS - All Is One
Babe Ruth - Dawn Richard - The Architect
Bad Image - Chained
Banda Black Rio - Mr. Funky Samba
Bang - Melenas - Ahora
Barry Can't Swim feat. Surya Sen - Always Get Through To You
Bathory - Enter the Eternal Fire
Beach Bunny - Cloud 9
Beanie Sigel & Freeway - Roc the Mic
Beck - Cant Help Falling in Love
Beck - Chemtrails
Best Coast - California Nights
Big Black - Kerosene
Bike - O Torto Santo
Birger Olsen - The Lights Just Buzz
Black Ends - Sellout
Black Pumas - Gemini Sun
Blackfire - Exile
Blair - Nightlife
Blaze - Found Love
Blonde Redhead - Kiss Her Kiss Her
Blood - Such Fun
Blotter Trax - Tramp
Blue Lake - Green-Yellow Field
Blue Monday - New Order - Blue Monday
Blue Monday - New Order - Power, Corruption & Lies
Blue Scholars - Slick Watts
Blur - Theres No Other Way
Bob Dylan - Final Theme
Bob Vylan - Dream Big
Bobby Hutcherson - Mirrors
Bobby Lee - Acid Grassland
Bombay Bicycle Club feat. Damon Albarn - Heaven
Bone ThugsnHarmony feat. Shatasha Williams - Thuggish Ruggish Bone
Brad - The Day Brings
Bratty - Radio
Brian Eno David Byrne - Defiant
Brick - Dazz
Brittany Davis - Sepricon
Brittany Howard - What Now
Brown Sugar - I'm in Love with a Dreadlocks
Bruk Rogers feat. Onj & Silva - Deusa
Bryan Ferry - Smoke Dreams of You
Bryan Ferry - The Chosen One
Buffalo Nichols - Cold Black Stare
Build a Bridge - Deeper - Careful!
Butterglory - The Skills of the Star Pilot
Buzzcocks - Why Cant I Touch It
Cabaret Voltaire - Crackdown
Caldera - Sky Islands
Calligram - Serpe
Camille Yarbrough - Take Yo Praise
Capsule - Shell
Caribou - Odessa
Caroline Polachek - Pretty in Possible
Caroline Polachek - Welcome to My Island
Cat Hoch - Look What You Found
Cat Power - Sea of Love
Chastity Belt - Hollow
Chastity Belt - Seattle Party
Chat Pile - grimace smoking weed.jpeg
Chequerboard - Vermilion
Cheree - A Choice
Chico Freeman - Illas
Chong the Nomad - Shake Step
Chris Acker - She Lives
Chris Pierce - 45 Jukebox
Christine and the Queens - Narcissus Is Back
Clark Terry - Spanish Rice
Cleo Sol - Go Baby
Clint Mansell - Welcome to Lunar Industries
Clinton Fearon - Crazy Ride (Live on KEXP)
Cloud Nothings - I'm Not Part of Me
Cloud One - Flying High
Cock & Swan - Inner Portal
Cocoa Tea - Good Life
Cocoa Tea - Weh Ya Gone
Color Green - Night
Corinne Bailey Rae - Corinne Bailey Rae
Courtney John - Lucky Man
Cowboy Sadness - First Rodeo
Crown Court - Hammer a Nail
Cry - Wonder 45 - Cry
Crystal Skulls - Locked Down
Cult of Love - Dum Dum Girls - Too True
Cult of Personality - Living Colour - Vivid
Cults - High Road
Curtis Harding - On and On
Curtis Harding - Welcome to My World
Cyberaktif - Nothing Stays
DEBBY FRIDAY - let u in
DEVO - (I Cant Get No) Satisfaction
DJ Koze - Pick Up
DJ Shadow - Midnight in a Perfect World (Gab mix)
DRAMA - Tighten It Up
Da Brat - Give It 2 You (EP version)
Da Brat feat. The Notorious B.I.G. - Dirty B Side
Dallas Woods - Colorblind
Damn Gloves - serpentwithfeet feat. Ty Dolla $ign & Yanga YaYa - GRIP
Daniel Norgren - Music Tape
David Bowie - Ashes to Ashes
David Bowie - Blackstar
David Bowie - Changes
David Bowie - Five Years
David Bowie - Golden Years (The Reflex Revision)
David Bowie - Modern Love
David Bowie - Moonage Daydream
David Bowie - Rebel Rebel
David Bowie - Right
David Bowie - Space Oddity
David Bowie - Suffragette City
David Bowie - The Jean Genie
David Bowie - Where Are We Now?
David Holmes & Raven Violet - Stop Apologising
Day Wave - As You Are
Dazz - Brick - Good High
De La Soul - Stakes Is High
Dead Kennedys - Stealing Peoples Mail
Dean Johnson - Faraway Skies
Deap Vally - Baby I Call Hell (Deap Vallys Version)
Death in Vegas - Girls
Deerhunter - Nothing Ever Happened
Depeche Mode - Heroes
Destroyer - Kaputt
Digable Planets - Jettin
Divide and Dissolve - Desire
Django Django feat. Yuuko Sings - Dont Touch That Dial
Don Carlos - I'm Not Getting Crazy
Don McLean - Vincent (Starry, Starry Night)
Don't Thank Me Spank Me! - Sandy
Donald Byrd - (Fallin Like) Dominoes
Dorpsstraat 3 - Dracula
Dos Santos - Jaguar de Rosas
Doug Paisley - If I Wanted To
Dr. Dog - My Old Ways
Dr. Lonnie Smith - Psychedelic Pi
Dr. Octagon - Blue Flowers
Durand Jones - Lord Have Mercy
Dusky - Mr Man (Dusky Revisit)
Earth, Wind & Fire - Boogie Wonderland (the Reflex Revision)
Earth, Wind & Fire - Keep Your Head to the Sky
Echo & the Bunnymen - Bring On the Dancing Horses
Echo and the Bunnymen - Its Alright
Eddie Kendricks - Date With The Rain
El Que - Angelica Garcia - El Que
Elixir - George Riley - Un/limited Love
Elliott Smith - Miss Misery
Elvis Presley - Blue Moon
Elvis Presley - Suspicious Minds
Emerson - Sending All My Love Out (Detroit in Effect Remix)
Empty Country - Pearl
English Teacher - Nearly Daffodils
Ernest Ranglin - 54-46 (Was My Number)
Esper Star - Boys of Summer
Esthero with Danny Saber - Song for Holly
Eternal Evil - Guerilla Warfare
Everything But the Girl - Everything But the Girl
Everything but the Girl - Caution To The Wind
Expansions - Kid Hops -
Far away Nebraska - Il vento mi parla di te
Fastbacks - In America
Fatboy Slim - Praise You
Feel It All Around - Washed Out - Life of Leisure
Fela Kuti - Zombie
Finom - Mine
Fire and Rain - James Taylor - Sweet Baby James
First Aid Kit - My Silver Lining
Fishbone - Unyielding Conditioning
Fleetwood Mac - Silver Springs
Flock of Dimes - Price of Blue
Foals - Bad Habit
Free Nationals feat. Chronixx - Eternal Light
Front Line Assembly - Mindphaser
Fugitive - Raise The Dead
Funkdoobiest - Bow Wow Wow
Future Islands - Seasons (Waiting on You) (BADBADNOTGOOD Reinterpretation)
GEL - Honed Blade
Gabriel Teodros - Open Letter to My Cousins in Israel
Gabriels - Blame
Gappy Ranks - Heavy Load
Gen and the Degenerates - Famous
Genders - Technicolor Vision
George Clinton - Atomic Dog
Gil Evans - Where Flamingos Fly
Gil Scott-Heron and Jamie xx - NY Is Killing Me
Giorgio Tuma & Laetitia Sadier - Through Your Hands Love Can Shine
Glitterfox - Its Always Over
Goldfrapp - Strict Machine
Goodness - Smoking
Goodness - Superwise
Gorillaz - DARE
Grachan Moncur III - Evolution
Grave Turner - Endless Steam
Greater Than One - Now Is The Time
Green Lady - Merchandise - After The End
Greg Foat & Gigi Masin - Leo Theo
Greg Foat & Gigi Masin - Viento calido
Greg Vandy - The Roadhouse
Gregory Isaacs - Love is Overdue
Gridiron - Ain't Turned Mine
Grouplove - Tongue Tied
Guided by Voices - Teenage FBI
Haram - /? "Where Were You on 9/11?"
Hard Stripes - Laughter
Heatmiser - Plainclothes Man
High-Functioning Flesh - Hands at Play
Hillsboro - Closer
Hooverphonic - 2Wicky
Horace Andy - Government Land
Horace Andy - Just Say Who
Hot Hot Heat - Talk to Me, Dance With Me
HotWax - E Flat
Hotline TNT - Protocol
Hurray for the Riff Raff - Alibi
IDLES - Dancer
IDLES - Grace
Ibibio Sound Machine - Electricity
Idoipe - El jilguerillo
Idris Muhammad - Soulful Drums
Incendiary - Lie of Liberty
Inculter - Fatal Visions
Indecision - Blindfold
Izm - Battles feat. Shabazz Palaces - Juice B Crypts
J Foerster / N Kramer - Endless
J Mascis - Cant Believe We're Here
JJ Whitefield - Flute Punch
Jake Blount - The Downward Road
Jalen Ngonda - Give Me Another Day
James Blake - Overgrown
James Taylor - Slow Burning Love
Jamie xx - Let's Do It Again
Jamila Woods - Bugs
Jamiroquai - Canned Heat (remastered)
Jasmine Myra - Horizons
Jeff Buckley - Grace
Jeffrey Silverstein - No Rain
Jenn Champion - Well Played
Jennifer Vanilla - Take Me For a Ride (Jerry Paper Remix)
Jimmy Riley - Gunman of JA
Jockstrap & Taylor Skye - Good Girl
John Coltrane - Untitled Original 11386
Johnny Clarke - Enter Into His Gate with Praise
Joneses - Love Contest
Jorja Smith - Little Things
Jorja Smith - She Feels
Jungle - Us Against The World
KAYTRANADA & Rochelle Jordan - Lover/Friend
Kamaal Williams - Stings
Kansas - Carry On Wayward Son
Karen y Los Remedios - Presagio
Keep on Dancing - Parov Stelar feat. Marvin Gaye - The Art of Sampling
Kelley Stoltz - Ever Thought of Coming Back
Kendrick Lamar, SZA - All The Stars
Kenny Smith - Trust in Him
Kid Hops - Expansions
Kid Hops - Positive Vibrations
King Crimson - I Talk to the Wind
King Gizzard & The Lizard Wizard - Gilgamesh
King Krule - Cellular
King Youngblood - too late, too soon
Klaus Nomi - The Cold Song (Vladimir Cauchemar Remix)
Kool Music - Sand Fly
Krigsgrav - The Black Oak
L'Eclair - Taishi Koto Pt. 1
L.I.P.S. - Old Man
LCD Soundsystem - No Love Lost
LIA LIA - Angst
LRain - Knead Bee
LRain - Pet Rock
La Sonora Dinamita - Ay chave
Laith - 79
Laurie Anderson - Flow
Lee Baggett - All Star Day
Les McCann - Sometimes I Cry
Les McCann - Talk to the People
Lil Yachty - the BLACK seminole.
Little Carl Carlton - Two Timer
Little Dragon - Tumbling Dice
Little Venom - Sabotage
Liza Anne - Rainbow Sweater
Lloyd Parks - Slaving
Los Amigos Invisibles - Ultra-funk
Los Angeles (feat. James Murphy) - Lol Tolhurst, Budgie & Jacknife Lee - Los Angeles
Los Colognes - Bird of Paradise
Loveshadow - Power Melts Away
Luna - 23 Minutes In Brussels
Luna - Chinatown
Luna - Pup Tent
Luna - Thank You For Sending Me An Angel
Lush - Hypocrite
Lusine - Plateau
Lutan Fyah - Soulmate
M. Ward - supernatural thing
M.I.S. - Unmarked Graves
MELONYX - At the Door
METZ - Spit You Out
MF DOOM - Doomsday feat Pebbles the Invisible Girl
MGMT - Mother Nature
ML Buch - Dust beam
MONSTERWATCH - I Don't Get It
Macklemore & Ryan Lewis - My Oh My
Malfunkshun - Until the Ocean
Mali Velasquez - Bobby
Malphino - Strange Salsa
Maribou State - Blackoak
Marvin Gaye - What's Going On
Masta Ace Incorporated - Born to Roll
Max Bien-Kahn - Run
Mazzy Star - Bells Ring
Meat Beat Manifesto - Psyche-Out (Sex Skank Mix)
Melba Moore - Your Sweet Lovin
Melenas - Bang
Melodys Echo Chamber - I Follow You
Men at Work - Who Can It Be Now?
Mi Amigo Invencible - Todo lo que Tengo
Middle Kids - Bend
Middle Kids - Dramamine
Mindtrap - Telehealth - Mindtrap
Missy Elliott feat. Da Brat - Sock It 2 Me
Modern English - I Melt With You
Modest Mouse - Exit Does Not Exist
More Than This - Roxy Music - Avalon
Mother Love Bone - Chloe Dancer / Crown of Thorns
Mother Love Bone - Heartshine
Multiple Man - Power Fantasy
My Morning Jacket - Touch Me I'm Going to Scream, Part 1
Natalia Lafourcade - Muerte
Nation of Language - Spare Me the Decision (Cutouts Remix)
Negative Vortex - Chant for the Undertaker
Never Ending Game - Never Die
Nice as Fuck - Runaway
Nick Drake - Northern Sky
Nina Simone - Just Like Tom Thumbs Blues
Nina Soul - Sleeping Trees
Nite Jewel - Skinny Dipper
Nusantara Beat - Borondong Garing (Edit)
Odor Eater - Magnetik
Oh, Rose - Back 2 U
One Monkey - Redbone - Message From a Drum
One Way Sky - Indian Route 15
Orion - Higher
Oscar Peterson - Wave
OutKast - Crumblin Erb
PJ Harvey - Big Exit
PVA - Hero Man
Pachyman - Toyota Nuevo
Pacific Air - Bear
Pelada - Acabemos Con El Femicidio
Pentagram - 20 Buck Spin
Pete Rock & C.L. Smooth - I Got a Love
Pete Rock & C.L. Smooth - They Reminisce Over You (T.R.O.Y.)
Peter Gabriel - Love Can Heal (Bright-Side Mix)
Peter Gabriel - i/o (BrightSide mix)
Peter Murphy - Cuts You Up
Petunia & the Vipers - Mercy
Physical Wash - Faith
Pinback - Fortress
Pink Floyd - Another Brick in the Wall, Part 2
Pizzicato Five - My Baby Portable Player Sound (High Llamas Remix)
Playing Favorites - Sheer Mag - Playing Favorites
Plum Vision - Roll The Dice
Pointed Sticks - Somebody's Mom
Populous feat. Ela Minus - Azul oro
Portishead - Sour Times
Powerplant - A Spine
Prince & The Revolution - Purple Rain
Prince - 1999
Prince Jammy - Government Dub
Prom Queen - Vengeance (Will Be Mine)
Psychic TV - Turn On, Tune In To The Acid House (Original PTV Mix)
Puerta Negra - Control
Quelle Chris & Chris Keys - SUDDEN DEATH
Radiohead - Burn the Witch
Radiohead - High and Dry
Rainbow Country - Bob Marley vs Funkstar De Luxe -
Ranking Toyan - Spar Wid Me
Rayland Baxter - Memories Of Old Hickory
Real Estate - Water Underground
Redman - Rockafella
Resavoir - Sunset
Resin Tomb - Human Confetti
Reverend Baron - Jackie
Richie Spice - Open the Door
Richie Spice - Youth Dem Cold
Rick Holmes - Remember To Remember
Ricky Reed, Terrace Martin & St. Panther - Real Magic
Ringworm - Sideshow (demo)
Rob Ruha - Taera
Robert Connely Farr & The Rebeltone Boys - Just Jive
Robert Ellis - Topo Chico
Robyn Hitchcock - Viva! SeaTac
Ron Morelli - Tangled Trap of Love
Roosevelt - Luna
Rose City Band - Rip City
Roy Davis Jr. - Gabrielle
Rufus and Chaka Khan - Aint Nobody
SHYGUY - Im So Trash
SIPHO - GLUE
SIPHO - SOBER
SPRINTS - Adore Adore Adore
SPRINTS - Up and Comer
SZA - Conceited
Sally Shapiro - Fading Away
Sampha - Dancing Circles
Sampha - Stereo Colour Cloud (Shamans Dream)
Sarah - Diplo - Florida
Savage - Let It Loose
Say She She - Astral Plane
Say She She - Forget Me Not
Say She She - Think About It
Say Sue Me - 4am
Schammasch - In Dialogue With Death
Scott Hirsch - Blue Rider
Sea Lemon - Sunday
Seal - Crazy
Seax - Rituals
Seu Jorge - Ziggy Stardust
Sex Pistols - Pretty Vacant
Shabazz Palaces feat. Royce The Choice - Binoculars
Sharon Van Etten - Close To You
Shawn Hess - Friend
Sheer Mag - Playing Favorites
Shirley Scott - Because
Shuggie Otis - Strawberry Letter 23
Shygirl & Cosha - thicc
Sinkane feat. Tru Osborne - Everything is Everything
Siouxsie and the Banshees - Fall From Grace
Sister Sledge - Lost in Music
SleaterKinney - Hell
SleaterKinney - Say It Like You Mean It
Sleigh Bells - Rill Rill
Smith Westerns - Weekend
So Pitted - Unfree
Solange - Cranes in the Sky
Somniate - A Lamb at False Dawn
Spencer Cullums Coin Collection - Cold Damp Valley
Spirit Award - South Dakota Cops
Spiritualized - Born Never Asked
Spiritualized - Electricity
Spiritualized - Ladies and Gentlemen We Are Floating in Space
Spoon - Inside Out
Spoon - The Underdog
Squeeze - Cool for Cats
Star Party - Living a Lie
Stephen & Damian Marley - Traffic Jam
Stephen Malkmus and the Jicks - Lariat
Stereophonics - Dakota
Stevie Wonder - Too High
Straight To The Point - Pressure Point - 7" 45 RPM
Strangelily - Monster Under The Bed
Sufjan Stevens - Will Anybody Ever Love Me?
Sugar Minott - Give Me Jah Jah
SummerPearl - feel right
Sunsick Daisy - Underwater
Supercrush - On The Telephone
Supergrass - Alright
Supreme La Rock - Sunday Soul
Swell - Golden Years
TLC - Sumthin Wicked This Way Comes
TORRES - Collect
TV on the Radio - Caffeinated Consciousness
TV on the Radio - Right Now
Tacocat - New World
Talk Talk - Its My Life
Tame Impala - One More Year
Tanya Tagaq - Colonizer
Tarrus Riley - Poverty Nuh Inna Fashion
Tasmin Archer - Sleeping Satellite
Telehealth - Mindtrap
The Adults Are Talking - The Strokes - The New Abnormal
The Avengers - The American In Me
The Beat - I Confess
The Beatles - Now and Then
The Cardigans - Lovefool
The Cecil Holmes Soulful Sounds - Also Sprach Zarathrustra (2001)
The Champs - Tequila
The Chemical Brothers - The Weight
The Chisel - Fuck 'Em
The Clash - Straight To Hell
The Clean - Are You Really On Drugs?
The Coasters - Down in Mexico
The Coup - Fat Cats, Bigga Fish
The Cranberries - Zombie
The Creative Technology Consortium - Sympathetic Ear
The Cure - In Between Days
The Dead Milkmen - Punk Rock Girl
The Deslondes - Good to Go
The Expelled - Blown Away
The Futureheads - Hounds of Love
The Garbage & the Flowers - Love Comes Slowly Now
The Greatest Smile - SAULT - Today & Tomorrow
The Jesus and Mary Chain - jamcod
The Kingsmen - Louie Louie
The Lady of Rage - Afro Puffs (LP version)
The Last Dinner Party - Sinner
The Lonely Forest - I Dont Want to Live There
The Magnetic Fields - Drive On, Driver
The Magnetic Fields - When My Boy Walks Down the Street
The Mighty Diamonds - Africa
The Modernettes - Teen City
The Nude Party - Tell Em
The Radio Dept. - You Stopped Making Sense
The Replacements - The Ledge
The Spinanes - Hawaiian Baby
The Tornadoes - Bustin Surfboards
The Veldt - Aurora Borealis
The Viletones - Rebel
The Voices of East Harlem - Cashing In
The Weeknd - Out of Time
The Wild Tchoupitoulas - Brother John
The xx - On Hold
Theo Lawrence - The Worst in Me
These Arms Are Snakes - Coporeal
They Might Be Giants - Your Racist Friend
Tim Hill - Payador
Tobacco City - Blue Raspberry
Tobacco City - Till The Moon Don't Shine
Tom Tom Club - Genius of Love
Tom Waits - (Looking for) The Heart of Saturday Night
Train - Goldfrapp - Black Cherry
Travesura - Messenger Pigeon
Trevor Horn feat. Iggy Pop & Lambrini Girls - Personal Jesus
Ty Segall - My Lady's On Fire
U2 - Pride (In the Name of Love)
UMI - why dont we go
Ultimate Painting - Silhouetted Shimmering
Unfinished Business - Holding On
Unknown Mortal Orchestra - Multi-Love
Van Houten - Coming Of Age
Veruca Salt - Seether
Vexx - Step Inside
Visors & Moon King - Turning (Inside Out)
Waahli - Bom Pase
Wall Drugs - Blind
Warpaint - New Song
Ween - Bananas and Blow
Western Violence - Spirit Award - The Fear
Whitney K - Hit This Pipe
Who Is She? - Thursday
William S. Fischer - There's a Light That Shines
Winston McAnuff & Johnny Osbourne - Baltimore
Wipers - Doom Town
Wire - Ex Lion Tamer
Wishy - Spinning
Witch Vomit - Doomed in the Realm of the Dead
Wonder 45 - Cry
Wyatt C. Louis - Dancing With Sue
XTC - Snowman
Y La Bamba - Cuatro Crazy
Yard Act - Petroleum
Yeasayer - Ambling Alp
Yesterdays New Quintet - The Birth of YNQ
Youth Lagoon - Football
Yves Tumor - Secrecy Is Incredibly Important to the Both of Them
Zanias - Burial
deary - 2000 Miles
gglum - Easy Fun
graves - Weather the Hard Times
ill peach - BLOOM
mega cat - Rat Fight